# # # # # # # # # # # # # # # # # # # # # # # # # # # # # # # #
#                                                             #
#                                                             #
#                                                             #
#                                                             #
#                                                             #
#                                                             #
#                                                             #
#                                                             #
#                                                             #
#                                                             #
#                                                             #
#                                                             #
#                                                             #
#                                                             #
#                                                             #
#                                                             #
#                                                             #
#                                                             #
#                                           F                 #
#                                                             #
#                                                             #
#                                                             #
#                                                             #
#                                                             #
#                                               0 0           #
#                                                             #
#                                                             #
#                                                             #
#                                                             #
#                                                             #
# # # # # # # # # # # # # # # # # # # # # # # # # # # # # # # #
