#############################################
#                                           #
#                                           #
#                                           #
#                                           #
#                                           #
#                                           #
#                                           #
#                                           #
#                                           #
#              ##                           #
#                                           #
#                                           #
#                                           #
#                      ###                  #
#                        #     #            #
#                        #     #            #
#                        #     #            #
#                        #######            #
#                                           #
#                                           #
#                                           #
#                                           #
#                                           #
#                                           #
#                00                         #
#                                           #
#                                           #
#                                           #
#############################################