#############################################
#                                           #
#                                           #
#                                           #
#                                           #
#                                           #
#                                           #
#                                           #
#                                           #
#                                           #
#                                           #
#                                           #
#                                           #
#                                           #
#                                           #
#                                           #
#                                           #
#                                           #
#                                           #
#            F                              #
#                                           #
#                                           #
#                                           #
#                                           #
#                                           #
#                00                         #
#                                           #
#                                           #
#                                           #
#############################################